--- 1층.png ---
--- 2층.png ---
--- 3층.png ---
--- 4층.png ---
--- 5층.png ---
--- 6층.png ---
--- 7층.png ---
